***********
*        G*
*         *
*** *******
*         *
*         *
******** **
*         *
*S        *
***********