**********
*       G*
* ****** *
*      * *
*      * *
*      * *
*      * *
*      * *
*S       *
**********