***********
*    *   G*
*    *    *
*    *    *
*    *    *
*    *    *
*    *    *
*S   *    *
*    *    *
*    *    *
***********
