***********
* *      G*
* * *******
*       * *
***** * * *
*         *
* *** *****
* * *     *
* * ***** *
*S        *
***********