********************
*                  *
*                  *
*                  *
*                  *
*                  *
*G       S         *
*                  *
*                  *
*                  *
********************
