***********
*S        *
*         *
*         *
*         *
*         *
*        G*
*         *
*         *
*         *
***********
