***********
*         *
*         *
*         *
*         *
*         *
*G       S*
*         *
*         *
*         *
***********
